572, 568
700, 390, 422
804, 566, 305, 357
404, 350, 144, 483, 359
720, 150, 403, 383, 487, 412
359,  39, 159, 143, 328, 368, 393
116, 114, 242, 589, 584, 548, 266, 397
100, 511, 372, 435, 255, 478, 258, 539, 363
135, 90, 355, 415, 225, 470, 125, 300, 355, 250
500, 580, 40, 80, 160, 320, 640, 200, 100, 50, 110
600, 60, 41, 81, 161, 321, 641, 201, 101, 51, 111, 90
